...........................................*...........................................
.*.........................................*.........................................*.
..*........................................*........................................*..
...*.......................................*.......................................*...
....*......................................*......................................*....
.....*.....................................*.....................................*.....
......*....................................*....................................*......
.......*...................................*...................................*.......
........*..................................*..................................*........
.........*.................................*.................................*.........
..........*................................*................................*..........
...........*...............................*...............................*...........
............*..............................*..............................*............
.............*.............................*.............................*.............
..............*............................*............................*..............
...............*...........................*...........................*...............
................*..........................*..........................*................
.................*.........................*.........................*.................
..................*........................*........................*..................
...................*.......................*.......................*...................
....................*......................*......................*....................
.....................*.....................*.....................*.....................
......................*....................*....................*......................
.......................*...................*...................*.......................
........................*..................*..................*........................
.........................*.................*.................*.........................
..........................*................*................*..........................
...........................*...............*...............*...........................
............................*..............*..............*............................
.............................*****************************.............................
.............................*****************************.............................
.............................*****************************.............................
.............................*****************************.............................
.............................*****************************.............................
.............................*****************************.............................
.............................*****************************.............................
.............................*****************************.............................
.............................*****************************.............................
.............................*****************************.............................
.............................*****************************.............................
.............................*****************************.............................
.............................*****************************.............................
.............................*****************************.............................
***************************************************************************************
.............................*****************************.............................
.............................*****************************.............................
.............................*****************************.............................
.............................*****************************.............................
.............................*****************************.............................
.............................*****************************.............................
.............................*****************************.............................
.............................*****************************.............................
.............................*****************************.............................
.............................*****************************.............................
.............................*****************************.............................
.............................*****************************.............................
.............................*****************************.............................
.............................*****************************.............................
............................*..............*..............*............................
...........................*...............*...............*...........................
..........................*................*................*..........................
.........................*.................*.................*.........................
........................*..................*..................*........................
.......................*...................*...................*.......................
......................*....................*....................*......................
.....................*.....................*.....................*.....................
....................*......................*......................*....................
...................*.......................*.......................*...................
..................*........................*........................*..................
.................*.........................*.........................*.................
................*..........................*..........................*................
...............*...........................*...........................*...............
..............*............................*............................*..............
.............*.............................*.............................*.............
............*..............................*..............................*............
...........*...............................*...............................*...........
..........*................................*................................*..........
.........*.................................*.................................*.........
........*..................................*..................................*........
.......*...................................*...................................*.......
......*....................................*....................................*......
.....*.....................................*.....................................*.....
....*......................................*......................................*....
...*.......................................*.......................................*...
..*........................................*........................................*..
.*.........................................*.........................................*.
...........................................*...........................................
