.........................*.........................
.*.......................*.......................*.
..*......................*......................*..
...*.....................*.....................*...
....*....................*....................*....
.....*...................*...................*.....
......*..................*..................*......
.......*.................*.................*.......
........*................*................*........
.........*...............*...............*.........
..........*..............*..............*..........
...........*.............*.............*...........
............*............*............*............
.............*...........*...........*.............
..............*..........*..........*..............
...............*.........*.........*...............
................*........*........*................
.................*****************.................
.................*****************.................
.................*****************.................
.................*****************.................
.................*****************.................
.................*****************.................
.................*****************.................
.................*****************.................
***************************************************
.................*****************.................
.................*****************.................
.................*****************.................
.................*****************.................
.................*****************.................
.................*****************.................
.................*****************.................
.................*****************.................
................*........*........*................
...............*.........*.........*...............
..............*..........*..........*..............
.............*...........*...........*.............
............*............*............*............
...........*.............*.............*...........
..........*..............*..............*..........
.........*...............*...............*.........
........*................*................*........
.......*.................*.................*.......
......*..................*..................*......
.....*...................*...................*.....
....*....................*....................*....
...*.....................*.....................*...
..*......................*......................*..
.*.......................*.......................*.
.........................*.........................
