.................................................*.................................................
.*...............................................*...............................................*.
..*..............................................*..............................................*..
...*.............................................*.............................................*...
....*............................................*............................................*....
.....*...........................................*...........................................*.....
......*..........................................*..........................................*......
.......*.........................................*.........................................*.......
........*........................................*........................................*........
.........*.......................................*.......................................*.........
..........*......................................*......................................*..........
...........*.....................................*.....................................*...........
............*....................................*....................................*............
.............*...................................*...................................*.............
..............*..................................*..................................*..............
...............*.................................*.................................*...............
................*................................*................................*................
.................*...............................*...............................*.................
..................*..............................*..............................*..................
...................*.............................*.............................*...................
....................*............................*............................*....................
.....................*...........................*...........................*.....................
......................*..........................*..........................*......................
.......................*.........................*.........................*.......................
........................*........................*........................*........................
.........................*.......................*.......................*.........................
..........................*......................*......................*..........................
...........................*.....................*.....................*...........................
............................*....................*....................*............................
.............................*...................*...................*.............................
..............................*..................*..................*..............................
...............................*.................*.................*...............................
................................*................*................*................................
.................................*********************************.................................
.................................*********************************.................................
.................................*********************************.................................
.................................*********************************.................................
.................................*********************************.................................
.................................*********************************.................................
.................................*********************************.................................
.................................*********************************.................................
.................................*********************************.................................
.................................*********************************.................................
.................................*********************************.................................
.................................*********************************.................................
.................................*********************************.................................
.................................*********************************.................................
.................................*********************************.................................
.................................*********************************.................................
***************************************************************************************************
.................................*********************************.................................
.................................*********************************.................................
.................................*********************************.................................
.................................*********************************.................................
.................................*********************************.................................
.................................*********************************.................................
.................................*********************************.................................
.................................*********************************.................................
.................................*********************************.................................
.................................*********************************.................................
.................................*********************************.................................
.................................*********************************.................................
.................................*********************************.................................
.................................*********************************.................................
.................................*********************************.................................
.................................*********************************.................................
................................*................*................*................................
...............................*.................*.................*...............................
..............................*..................*..................*..............................
.............................*...................*...................*.............................
............................*....................*....................*............................
...........................*.....................*.....................*...........................
..........................*......................*......................*..........................
.........................*.......................*.......................*.........................
........................*........................*........................*........................
.......................*.........................*.........................*.......................
......................*..........................*..........................*......................
.....................*...........................*...........................*.....................
....................*............................*............................*....................
...................*.............................*.............................*...................
..................*..............................*..............................*..................
.................*...............................*...............................*.................
................*................................*................................*................
...............*.................................*.................................*...............
..............*..................................*..................................*..............
.............*...................................*...................................*.............
............*....................................*....................................*............
...........*.....................................*.....................................*...........
..........*......................................*......................................*..........
.........*.......................................*.......................................*.........
........*........................................*........................................*........
.......*.........................................*.........................................*.......
......*..........................................*..........................................*......
.....*...........................................*...........................................*.....
....*............................................*............................................*....
...*.............................................*.............................................*...
..*..............................................*..............................................*..
.*...............................................*...............................................*.
.................................................*.................................................
