...............................*...............................
.*.............................*.............................*.
..*............................*............................*..
...*...........................*...........................*...
....*..........................*..........................*....
.....*.........................*.........................*.....
......*........................*........................*......
.......*.......................*.......................*.......
........*......................*......................*........
.........*.....................*.....................*.........
..........*....................*....................*..........
...........*...................*...................*...........
............*..................*..................*............
.............*.................*.................*.............
..............*................*................*..............
...............*...............*...............*...............
................*..............*..............*................
.................*.............*.............*.................
..................*............*............*..................
...................*...........*...........*...................
....................*..........*..........*....................
.....................*********************.....................
.....................*********************.....................
.....................*********************.....................
.....................*********************.....................
.....................*********************.....................
.....................*********************.....................
.....................*********************.....................
.....................*********************.....................
.....................*********************.....................
.....................*********************.....................
***************************************************************
.....................*********************.....................
.....................*********************.....................
.....................*********************.....................
.....................*********************.....................
.....................*********************.....................
.....................*********************.....................
.....................*********************.....................
.....................*********************.....................
.....................*********************.....................
.....................*********************.....................
....................*..........*..........*....................
...................*...........*...........*...................
..................*............*............*..................
.................*.............*.............*.................
................*..............*..............*................
...............*...............*...............*...............
..............*................*................*..............
.............*.................*.................*.............
............*..................*..................*............
...........*...................*...................*...........
..........*....................*....................*..........
.........*.....................*.....................*.........
........*......................*......................*........
.......*.......................*.......................*.......
......*........................*........................*......
.....*.........................*.........................*.....
....*..........................*..........................*....
...*...........................*...........................*...
..*............................*............................*..
.*.............................*.............................*.
...............................*...............................
