....*....
.*..*..*.
..*.*.*..
...***...
*********
...***...
..*.*.*..
.*..*..*.
....*....
