..................................*..................................
.*................................*................................*.
..*...............................*...............................*..
...*..............................*..............................*...
....*.............................*.............................*....
.....*............................*............................*.....
......*...........................*...........................*......
.......*..........................*..........................*.......
........*.........................*.........................*........
.........*........................*........................*.........
..........*.......................*.......................*..........
...........*......................*......................*...........
............*.....................*.....................*............
.............*....................*....................*.............
..............*...................*...................*..............
...............*..................*..................*...............
................*.................*.................*................
.................*................*................*.................
..................*...............*...............*..................
...................*..............*..............*...................
....................*.............*.............*....................
.....................*............*............*.....................
......................*...........*...........*......................
.......................***********************.......................
.......................***********************.......................
.......................***********************.......................
.......................***********************.......................
.......................***********************.......................
.......................***********************.......................
.......................***********************.......................
.......................***********************.......................
.......................***********************.......................
.......................***********************.......................
.......................***********************.......................
*********************************************************************
.......................***********************.......................
.......................***********************.......................
.......................***********************.......................
.......................***********************.......................
.......................***********************.......................
.......................***********************.......................
.......................***********************.......................
.......................***********************.......................
.......................***********************.......................
.......................***********************.......................
.......................***********************.......................
......................*...........*...........*......................
.....................*............*............*.....................
....................*.............*.............*....................
...................*..............*..............*...................
..................*...............*...............*..................
.................*................*................*.................
................*.................*.................*................
...............*..................*..................*...............
..............*...................*...................*..............
.............*....................*....................*.............
............*.....................*.....................*............
...........*......................*......................*...........
..........*.......................*.......................*..........
.........*........................*........................*.........
........*.........................*.........................*........
.......*..........................*..........................*.......
......*...........................*...........................*......
.....*............................*............................*.....
....*.............................*.............................*....
...*..............................*..............................*...
..*...............................*...............................*..
.*................................*................................*.
..................................*..................................
