......................*......................
.*....................*....................*.
..*...................*...................*..
...*..................*..................*...
....*.................*.................*....
.....*................*................*.....
......*...............*...............*......
.......*..............*..............*.......
........*.............*.............*........
.........*............*............*.........
..........*...........*...........*..........
...........*..........*..........*...........
............*.........*.........*............
.............*........*........*.............
..............*.......*.......*..............
...............***************...............
...............***************...............
...............***************...............
...............***************...............
...............***************...............
...............***************...............
...............***************...............
*********************************************
...............***************...............
...............***************...............
...............***************...............
...............***************...............
...............***************...............
...............***************...............
...............***************...............
..............*.......*.......*..............
.............*........*........*.............
............*.........*.........*............
...........*..........*..........*...........
..........*...........*...........*..........
.........*............*............*.........
........*.............*.............*........
.......*..............*..............*.......
......*...............*...............*......
.....*................*................*.....
....*.................*.................*....
...*..................*..................*...
..*...................*...................*..
.*....................*....................*.
......................*......................
