??       ???
???     ????
???     ????
????? ??????
????????????
????????????
????????????
????????????
????????????
????????????
????????????
????????????
